border_size=1
usage=map

Gg, Gg, Gg, Gll^Fmw, Gll^Fmw, Gll^Fmw, Gll^Fmw, Gg, Gg, Gll^Fmw, Gll^Fmw, Gg, Gg, Gg, Gg, Gg, Gs, Gg, Gg, Gg, Gs, Gg, Gs, Gg, Gg, Gg, Gg, Gll^Fmw, Gll^Fmw, Gll^Fmw, Gll^Fmw, Gll^Fmw, Gll^Fmw, Gll^Fmw, Gll^Fmw, Gg, Gg, Gg, Gg, Gg, Gg, Gg, Gg, Gg, Gg, Gg, Gg, Gg, Gg, Gg, Gg, Gg
Gll^Fmw, Gll^Fmw, Gll^Fmw, Gg, Gll^Fmw, Gll^Fmw, Gll^Fmw, Gg, Gg, Gll^Fmw, Gll^Fmw, Gll^Fmw, Gg, Gg, Gg, Gg, Gg, Gs, Gg, Gg, Gg, Gs, Gg, Gg, Gg, Gg, Gg, Gll^Fmw, Gll^Fmw, Gll^Fmw, Gll^Fmw, Gll^Fmw, Gll^Fmw, Gll^Fmw, Gll^Fmw, Gg, Gll^Fdw, Gll^Fdw, Gs, Gg, Gg, Gg, Gg, Gg, Gs, Gg, Gs, Gg, Gg, Gg, Gs, Gs
Gs, Gll^Fmw, Gll^Fmw, Gll^Fmw, Gll^Fmw, Gll^Fmw, Gs, Gg, Gll^Fmw, Gll^Fmw, Gll^Fmw, Gll^Fmw, Gg, Gg, Gs, Gg, Gg, Gs, Gg, Gg, Gs, Gs, Gs, Gg, Gg, Gg, Gg, Gg, Gg, Gll^Fmw, Gg, Gll^Fmw, Gg, Gll^Fmw, Gll^Fmw, Gll^Fmw, Gll^Fdw, Gll^Fdw, Gg, Gg, Gg, Gg, Gd, Gs, Gll, Gs, Gll, Gg, Gll^Fdw, Gs, Gll^Fdw, Gg
Gll^Fmw, Gs, Gg, Gll^Fmw, Gll^Fmw, Gs, Gll^Fmw, Gll^Fmw, Gll^Fmw, Gll^Fmw, Gg, Gg, Gg, Gs, Gg, Gg, Gg, Gg, Gg, Gg, Gs, Gs, Gg, Gg, Gg, Gs, Gg, Gg, Gs, Gg, Gg, Gg, Gg, Gg, Gg, Gll^Fdw, Gs, Gg, Gg, Gg, Gll^Fdw, Gd, Gll, Gll, Gll, Gll, Gll, Gd, Gll^Fdw, Gg, Gg, Gg
Gll^Fmw, Gll^Fmw, Gll^Fmw, Gg, Gg, Gs, Gg, Gll^Fmw, Gg, Gll^Fmw, Gg, Gg, Gg, Gs, Gg, Gg, Gg, Gg, Gg, Gg, Kh, Gs, Gg, Gg, Gg, Gg, Gg, Gg, Gg, Gg, Gg, Gg, Gg, Gg, Gs, Gg, Gg, Gg, Gll^Fdw, Gll^Fdw, Gll^Fdw, Gll^Fdw, Gll, Gd, Gll, Gd, Gd, Gll^Fdw, Gll^Fdw, Gg, Gg, Gg
Gll^Fmw, Gll^Fmw, Gll^Fmw, Gg, Gg, Gg, Hh, Gg, Gg, Gg, Gs, Gg, Gg, Gg, Ch, Kh, Ch, Ch, Ch, Ch, Ch, Ch, Ch, Ch, Ch, Kh, Ch, Gg, Gg, Gg, Gg, Gg, Gg, Gs, Gg, Gg, Gg, Gg, Gg, Gll^Fdw, Gll^Fdw, Gd, Gll, Gll, Gd, Gll, Gll, Gll^Fdw, Gs, Gd, Gg, Gg
Gll^Fmw, Gll^Fmw, Gg, Gg, Gg, Hh, Hh, Hh, Gg, Gs, Gg, Gg, Ch, Ch, Rrc, Rrc, Rrc, Rrc, Rp, Rrc, Rrc, Rrc, Rrc, Rrc, Rrc, Rrc, Rrc, Ch, Ch, Gg, Gg, Gg, Gg, Gg, Gg, Gg, Gs, Gg, Gg, Gg, Gg, Gd, Rr^Vd, Gd, Gll, Gll, Gd, Gd, Gd, Gg, Gg, Gg
Gg, Gg, Gg, Gg, Hh, Hh, Gs, Hh, Gg, Gg, Gg, Kh, Rrc, Rrc, Rp, Rp, Rp^Vhc, Rrc, Rp, Rrc, Rrc, Rrc, Rp, Rrc, Rrc, Rrc, Rp, Rrc, Rrc, Kh, Gg, Gg, Gg, Gg, Gs, Gs, Hh, Gg, Gg, Gs, Gs, Gd, Gll, Gll, Gd, Gd, Gll^Fdw, Gll, Gd, Gg, Gll^Fdw, Gll^Fdw
Gg, Gg, Gg, Gg, Gs, Gs, Gg, Gs, Gg, Gg, Gg, Ch, Rrc, Rp, Gd^Efm, Rp, Rp, Rrc, Rrc, Rrc, Ch, Rp, Rrc, Rrc, Rrc, Rp^Vhc, Rp, Rrc, Rrc, Ch, Gg, Gg, Gg, Gg, Gg, Gg, Hh, Hh^Fmw, Gg, Gs, Gg, Gs, Gs, Gll, Gll, Gll^Fdw, Gll, Gll^Fdw, Gd, Gg, Gll^Fdw, Gll^Fdw
Gg, Gg, Gg, Gg, Gs, Gg, Gg, Gg, Gg, Gg, Gg, Ch, Rrc, Gs^Efm, Gd, Gd^Efm, Rp, Rrc, Rrc, Ch, Kh, Ch, Rrc, Rrc, Rrc, Rp, Rrc, Rrc, Rrc, Ch, Gg, Gg, Gg, Gg, Hh, Hh, Hh, Hh^Fmw, Gg, Gg, Gg, Gg, Gg, Gd, Gd, Gd, Gd, Gd, Gd, Gll^Fdw, Gg, Gg
Gg, Gg, Gg, Gg, Gg, Hh, Gg, Gg, Gg, Gg, Gg, Kh, Rrc, Gs^Efm, Gs^Efm, Gs^Efm, Rrc, Rrc, Rrc, Ch, Ch, Ch, Rp, Rrc, Rp, Rrc, Rrc, Rp, Rrc, Kh, Gg, Gg, Gg, Gg, Hh, Hh, Gg, Gs, Gs, Gg, Gs, Gg, Gg, Gg, Gd, Gd, Gll, Gd, Hhd^Fdw, Gg, Gg, Gg
Gg, Gg, Gg, Gg, Hh, Hh, Gg, Gg, Gg, Gg, Gg, Ch, Rp, Rp, Rp, Rp, Rp^Vd, Rrc, Rp, Rrc, Rrc, Rp, Rrc, Rrc, Rp, Rp, Rp^Vhc, Rp, Rrc, Ch, Gg, Gg, Gg, Gg, Gs, Gg, Gg, Gg, Gg, Gs, Hh^Fmw, Gg, Gg, Gg, Hhd, Gd, Gs, Gg, Hhd, Hhd^Fdw, Hhd, Gg
Gg, Gg, Gg, Gs, Hh, Hh, Gs, Gg, Gg, Gg, Gg, Ch, Rrc, Rrc, Rrc, Rrc, Rrc, Rp, Rp, Rp, Rrc, Rrc, Rp, Rrc, Rrc, Rrc, Rrc, Rrc, Rrc, Ch, Gg, Gs, Gg, Gs, Gg, Gg, Gg, Gg, Hh, Hh^Fmw, Hh^Fmw, Gg, Gg, Hh, Hhd, Gg, Gs, Gs, Gg, Hh, Hh, Hh
Gg, Gg, Gg, Gg, Gg, Gg, Gg, Gg, Gg, Gg, Gg, Kh, Ch, Rrc, Rrc, Rp, Rrc, Rrc, Rrc, Rrc, Rrc, Rp, Rrc, Rp, Rrc, Rrc, Rrc, Rrc, Ch, Kh, Gg, Gg, Gg, Gg, Gg, Gg, Gs, Gg, Hh, Hh, Gg, Gg, Gg, Hh, Hh, Gg, Gg, Gg, Gg, Gg, Gg, Hh
Hh, Hh, Gg, Gg, Gg, Gg, Gg, Gg, Gg, Gg, Gg, Gg, Gg, Ch, Ch, Rrc, Ch, Rrc, Ch, Rrc, Ch, Rrc, Ch, Rrc, Ch, Rrc, Ch, Ch, Gg, Gg, Gs, Gg, Gg, Gg, Gg, Gg, Gs, Gs, Gs, Hh, Gg, Gg, Gg, Gg, Gs, Gs, Gg, Gg, Gs, Gg, Gg, Gg
Hh, Hh, Gg, Gg, Gg, Gg, Gg, Gg, Hh, Gg, Gg, Gg, Gg, Gg, Gg, Kh, Gg, Ch, Gg, Ch, Kh, Ch, Gg, Ch, Gg, Kh, Gg, Gg, Gs, Gg, Gg, Gs, Gg, Gg, Gg, Gg, Gg, Gg, Gg, Gg, Gg, Gg, Gs, Gs, Gg, Gg, Gg, Gg, Gg, Gg, Gg, Gg
Hh, Hh, Gg, Gs, Gg, Gg, Hh, Hh, Hh, Gs, Gg, Gg, Gg, Gg, Gs, Gg, Gg, Gg, Gg, Gg, Gg, Gg, Gg, Gg, Gs, Gg, Gg, Gs, Gs, Gg, Gg, Gg, Gg, Gg, Gg, Gs, Gg, Gg, Gg, Gg, Gg, Gg, Gg, Gg, Gg, Gg, Gg, Gg, Gg, Gg, Gg, Gg
Hh, Gg, Gg, Gg, Gg, Hh, Gg, Gg, Gg, Gs, Gg, Gg, Gs, Gs, Gs, Gg, Gg, Gg, Gg, Gg, Gg, Gg, Gg, Gs, Gs, Gs, Gg, Gg, Gs, Gs, Gs, Gg, Gg, Gg, Gg, Gg, Gg, Gg, Gg, Gg, Gs, Gg, Gg, Gg, Gg, Gg, Gg, Gg, Gg, Gll^Fmw, Gg, Gg
Gg, Gg, Gs, Gg, Gg, Hh, Gg, Gg, Gg, Gg, Gg, Gg, Gs, Gg, Gg, Gg, Gg, Gg, Gll^Gvs, Gll^Gvs, Gll^Gvs, Gg, Gg, Gg, Gg, Gs, Gg, Gs, Gg, Gs, Gg, Gs, Gs, Gg, Gg, Gs, Gg, Gg, Gg, Gg, Gs, Gg, Gs, Gll^Fmw, Gll^Fmw, Gg, Gg, Gg, Gg, Gg, Gg, Gg
Gg, Gs, Gs, Gg, Gg, Gg, Gg, Gs, Gs, Gg, Gg, Gg, Gs, Gg, Gg, Gg, Gll^Gvs, Gll^Gvs, Gll^Gvs, Gll^Gvs, Gll^Gvs, Gll^Gvs, Gll^Gvs, Gg, Gg, Gs, Gs, Gg, Gg, Gg, Gs, Gs, Gs, Gs, Gs, Gs, Gs, Gg, Gg, Gg^Ve, Gs, Gs, Ds, Gll^Fmw, Gs, Gg, Gs, Gg, Gll^Fmw, Gg, Gg, Gg
Gg, Gs, Gg, Gg, Gg, Gg, Gs, Gs, Gg, Gg, Gg, Gs, Gg, Gs, Gg, Gll^Gvs, Gll^Gvs, Gll^Gvs, Gll^Gvs, Gll^Gvs, Gll^Gvs, Gll^Gvs, Gll^Gvs, Gll^Gvs, Gg, Gg, Gg, Gg, Gg, Gg, Gg, Gs, Gs, Gg, Gg, Gs, Gs, Gs, Gs, Gs, Ds^Bsb\, Ds, Wog, Ds, Ds, Gs, Gs, Gs, Gll^Fmw, Gg, Gs, Gg
Gg, Gg, Gg, Gg, Gg, Gg, Gg, Gg, Gg, Gg, Gg, Gg, Gll^Gvs, Gg, Gg, Gg, Gg, Gll^Gvs, Gg, Gg, Gg, Gll^Gvs, Gg, Gg, Gg, Gg, Gll^Gvs, Gll^Gvs, Gll^Gvs, Gg, Gg, Gg, Gg, Gg, Gg, Gg, Gg, Gg, Gs, Ds, Wog, Wog^Bsb\, Kv, Wog, Ds, Gs, Gg, Gs, Gs, Gg, Gs, Gg
Gg, Gg, Gs, Gg, Gg, Gg, Gg, Gg, Gg, Gg, Gll^Gvs, Gll^Gvs, Gll^Gvs, Gll^Gvs, Gll^Gvs, Gg, Gg, Gg, Gs^Vh, Gs, Gg, Gg, Gg, Gg, Gll^Gvs, Gll^Gvs, Gll^Gvs, Gll^Gvs, Gll^Gvs, Gll^Gvs, Gll^Gvs, Gg, Gg, Gg, Gg, Gg, Gg, Gg, Gs, Ds, Wog, Cv, Cv, Wog, Ds, Gs, Gg^Fet, Gg, Gg, Gg, Gs, Gg
Gs, Gs, Gg, Gg, Gs, Gg, Gg, Gg, Gg, Gll^Gvs, Gll^Gvs, Gll^Gvs, Gll^Gvs, Gll^Gvs, Gll^Gvs, Gll^Gvs, Gg, Gs, Gg, Gg, Gg, Gg, Gg, Gg, Gg, Gll^Gvs, Gll^Gvs, Gll^Gvs, Gll^Gvs, Gll^Gvs, Gg, Gg, Gg, Gg, Gg, Gg, Gg, Gg, Gll^Fmw, Ds, Ds, Wog, Wog^Bsb|, Wog, Ds, Gs, Gs, Gs, Gg, Gg, Gg, Gs
Gs, Gg, Gg, Gg, Gs, Gg, Gg, Gg, Gg, Gg, Gg, Gll^Gvs, Gll^Gvs, Gll^Gvs, Gg, Gg, Gg, Gs, Gg, Gg, Ce, Gg, Gs, Gll^Fmw, Gg, Gg, Gg, Gll^Gvs, Gg, Gg, Gll^Gvs, Gll^Gvs, Gg, Gg, Gg, Gg, Gg, Gg, Gs, Gs, Gs, Ds, Ds^Bsb|, Ds, Gs, Gs, Gs, Gg, Gs, Gs, Gs, Gg
Gg, Gg, Gg, Gg, Gg, Gs, Gg, Gg, Gg, Gg, Gg, Gg, Gg, Gg, Gg, Gll^Fmw, Gg, Gg, Gs, Gs, Ke, Ce, Gs, Gg, Gg, Gs, Gs, Gg, Gll^Gvs, Gll^Gvs, Gll^Gvs, Gll^Gvs, Gg, Gg, Gg, Gg, Gg, Gg, Gg, Gg, Gg^Ve, Gs, Gs, Gs, Gll^Fmw, Gll^Fmw, Gll^Fmw, Gg, Gg, Gs, Gg, Gg
Gg, Gg, Gg, Gg, Gg, Gs, Gg, Gg, Gg, Gg, Gg, Gg, Gg, Gg, Gg, Gg, Gs^Vc, Gg, Gs, Gs, Ce, Ce, Gs, Gg, Gg, Gg, Gs^Vc, Gg, Gll^Gvs, Gll^Gvs, Gll^Gvs, Gll^Gvs, Gg, Gg, Gg, Gg, Gs, Gg, Gg, Gg, Gg, Gs, Gs, Gg, Gg, Gg, Gs, Gs, Gg, Gg, Gg, Gg
Gll^Fmw, Gg, Gll^Fmw, Gg, Gg, Gg, Gll^Fmw, Gs, Gll^Fmw, Gg, Gg, Gg, Gg, Gs, Gs, Gs, Gs, Gg, Gg, Gs, Gg, Gg, Gs, Gg, Gs, Gs, Gs, Gg, Gll^Gvs, Gll^Gvs, Gll^Gvs, Gll^Gvs, Gg, Gg, Gg, Gs, Gs, Gg, Gg, Gg, Gg, Gg, Gs, Gg, Gg, Gg, Gs, Gg, Gg, Gg, Gg, Gg
Gll^Fmw, Gll^Fmw, Gll^Fmw, Gll^Fmw, Gll^Fmw, Gll^Fmw, Gll^Fmw, Gs, Gll^Fmw, Gll^Fmw, Gll^Fmw, Gg, Gg, Gg, Gg, Gg, Gll^Fmw, Gs, Gg, Gg, Gg, Gg, Gg, Gg, Gll^Gvs, Gg, Gg, Gg, Gll^Gvs, Gll^Gvs, Gg, Gg, Gg, Gg, Gg, Gg, Gg, Gg, Gg, Gg, Gg, Gg, Gg, Gg, Gg, Gg, Gg, Gg, Gg, Gg, Gg, Gg
Gg, Gll^Fmw, Gll^Fmw, Gll^Fmw, Gll^Fmw, Gll^Fmw, Gg, Gg, Gll^Fmw, Gll^Fmw, Gll^Fmw, Gll^Fmw, Gg, Gg, Gs, Gll^Fmw, Gll^Fmw, Gg, Gg, Gg, Gg, Gg, Gll^Gvs, Gll^Gvs, Gll^Gvs, Gg, Gg, Gg, Gg, Gg, Gg, Gg, Gg, Gg, Gg, Gg, Gg, Gs, Gs, Gg, Gg, Gs, Gg, Gg, Gs, Gg, Gg, Gg, Gg, Gg, Gg, Gg
Gg, Gll^Fmw, Gg, Gll^Fmw, Gg, Gll^Fmw, Gg, Gll^Fmw, Gll^Fmw, Gll^Fmw, Gll^Fmw, Gll^Fmw, Gll^Fmw, Gg, Gg, Gg, Gs, Gg, Gg, Gg, Gll^Gvs, Gll^Gvs, Gll^Gvs, Gll^Gvs, Gll^Gvs, Gg, Gg, Gg, Gg, Gg, Gs, Gs, Gll^Fmw, Gll^Fmw, Gg, Gg, Gg, Gg, Gg, Gg, Gs, Gg, Gg, Gs, Gg, Gg, Gg, Gg, Gg, Gg, Gg, Gg
Gg, Gg, Gll^Fmw, Gg, Gg, Gg, Gll^Fmw, Gll^Fmw, Gll^Fmw, Gll^Fmw, Gll^Fmw, Gll^Fmw, Gg, Gg, Gg, Gs, Gs, Gs^Vc, Gg, Gg, Gll^Gvs, Gll^Gvs, Gll^Gvs, Gll^Gvs, Gg, Gg, Gs, Gg, Gg, Gg, Gg, Gll^Fmw, Gll^Fmw, Gll^Fmw, Gg, Gll^Fmw, Gll^Fmw, Gg, Gg, Gg, Gg, Gs, Gg, Gg, Gg, Gg, Gg, Gg, Gg, Gg, Gg, Gg
Gll^Fmw, Gll^Fmw, Gll^Fmw, Gll^Fmw, Gll^Fmw, Gg, Gg, Gll^Fmw, Gll^Fmw, Gll^Fmw, Gs, Gg, Gll^Fmw, Gg, Gg, Gg, Gg, Gs, Gg, Gg, Gll^Gvs, Gll^Gvs, Gg, Gg, Gg, Gg, Gg, Gg, Gg, Gll^Fmw, Gll^Fmw, Gg, Gg, Gg, Gll^Fmw, Gll^Fmw, Gll^Fmw, Gg, Gg, Gg, Gg, Gs, Gg, Gg, Gg, Gg, Gg, Gg, Gg, Gg, Gg, Gg
Gll^Fmw, Gll^Fmw, Gll^Fmw, Gll^Fmw, Gll^Fmw, Gll^Fmw, Gll^Fmw, Gg, Gg, Gs, Gll^Fmw, Gll^Fmw, Gll^Fmw, Gll^Fmw, Gll^Fmw, Gg, Gg, Gg, Gg, Gg, Gg, Gg, Gg, Gg, Gg, Gg, Gg, Gg, Gg, Gll^Fmw, Gll^Fmw, Gll^Fmw, Gg, Gs, Gll^Fmw, Gll^Fmw, Gll^Fmw, Gg, Gg, Gg, Gg, Gg, Gs, Gg, Gg, Gg, Gg, Gg, Gll^Fmw, Gll^Fmw, Gll^Fmw, Gg
Gg, Gg, Gg, Gg, Gs, Gll^Fmw, Gll^Fmw, Gg, Gg, Gs, Gll^Fmw, Gll^Fmw, Gll^Fmw, Gll^Fmw, Gll^Fmw, Gg, Gg, Gg, Gg, Gg, Gg, Gg, Gg, Gg, Gg, Gs, Gg, Gg, Gg, Gll^Fmw, Gll^Fmw, Gll^Fmw, Gll^Fmw, Gs, Gll^Fmw, Gll^Fmw, Gg, Gg, Gg, Gg, Gg, Gg, Gs, Gg, Gll^Fmw, Gll^Fmw, Gll^Fmw, Gll^Fmw, Gll^Fmw, Gll^Fmw, Gll^Fmw, Gll^Fmw
Gg, Gg, Gll^Fmw, Gg, Gll^Fmw, Gs^Vc, Gg, Gg, Gll^Fmw, Gll^Fmw, Gll^Fmw, Gll^Fmw, Gll^Fmw, Gll^Fmw, Gg, Gg, Gg, Gg, Gg, Gg, Gg, Gg, Gg, Gg, Gg, Gg, Gg, Gg, Gg, Gg, Gg, Gll^Fmw, Gg, Gg, Gg, Gg, Gg, Gg, Gll^Fmw, Gll^Fmw, Gll^Fmw, Gg, Gg, Gg, Gg, Gll^Fmw, Gg, Gll^Fmw, Gs, Gll^Fmw, Gll^Fmw, Gll^Fmw
Gll^Fmw, Gll^Fmw, Gll^Fmw, Gll^Fmw, Gll^Fmw, Gs, Gg, Gg, Gg, Gll^Fmw, Gll^Fmw, Gll^Fmw, Gg, Gg, Gll^Fmw, Gg, Gg, Gs, Gg, Gg, Gg, Gg, Gs, Gg, Gg, Gg, Gg, Gg, Gg, Gg, Gg, Gg, Gg, Gg, Gg, Gg, Gll^Fmw, Gll^Fmw, Gll^Fmw, Gll^Fmw, Gll^Fmw, Gll^Fmw, Gs, Gg, Gll^Fmw, Gg, Gg, Gg, Gs, Gll^Fmw, Gll^Fmw, Gll^Fmw
Gll^Fmw, Gll^Fmw, Gg, Gll^Fmw, Gll^Fmw, Gs, Gll^Fmw, Gll^Fmw, Gll^Fmw, Gg, Gg, Gg, Gg, Gll^Fmw, Gll^Fmw, Gll^Fmw, Gg, Gg, Gg, Gg, Gg, Gg, Gs, Gg, Gg, Gg, Gg, Gg, Gg, Gg, Gs, Gg, Gg, Gg, Gg, Gg, Gg, Gg, Gg, Gll^Fmw, Gg, Gll^Fmw, Gs, Gg, Gll^Fmw, Gll^Fmw, Gll^Fmw, Gg, Gg, Gs, Gll^Fmw, Gll^Fmw
Gg, Gll^Fmw, Gll^Fmw, Gg, Gll^Fmw, Gll^Fmw, Gll^Fmw, Gll^Fmw, Gll^Fmw, Gll^Fmw, Gs, Gg, Gg, Gll^Fmw, Gll^Fmw, Gll^Fmw, Gg, Gg, Gg, Gg, Gg, Gg, Hh, Hh, Hh, Hh, Hh, Gg, Gg, Gs, Gg, Gg, Gg, Gg, Gg, Gg, Gll^Fmw, Gll^Fmw, Gll^Fmw, Gg, Gg, Gg, Gs, Gg, Gg, Gll^Fmw, Gll^Fmw, Gll^Fmw, Gll^Fmw, Gg, Gll^Fmw, Gll^Fmw
Gg, Gll^Fmw, Gll^Fmw, Gg, Gg, Gll^Fmw, Gll^Fmw, Gll^Fmw, Gll^Fmw, Gll^Fmw, Gs, Gg, Gll^Fmw, Gg, Gg, Gll^Fmw, Gg, Gg, Gg, Gg, Gg, Gg, Hh, Hh, Hh, Hh, Gg, Gg, Gg, Gs, Gg, Gg, Gg, Gg, Gg, Gg, Gll^Fmw, Gll^Fmw, Gll^Fmw, Gll^Fmw, Gll^Fmw, Gs, Gg, Gg, Gg, Gll^Fmw, Gll^Fmw, Gll^Fmw, Gll^Fmw, Gll^Fmw, Gll^Fmw, Gll^Fmw
Gll^Fmw, Gg, Gll^Fmw, Gg, Gs, Gg, Gg, Gg, Gg, Gg, Gs, Gll^Fmw, Gll^Fmw, Gll^Fmw, Gll^Fmw, Gg, Gg, Gg, Gg, Gg, Gg, Hh, Hh, Hh, Hh, Gg, Gg, Gg, Gg, Gg, Gg, Gs, Gg, Gg, Gg, Gg, Gg, Gll^Fmw, Gll^Fmw, Gll^Fmw, Gg, Gg, Gg, Gs, Gg, Gg, Gg, Gg, Gll^Fmw, Gll^Fmw, Gll^Fmw, Gll^Fmw
Gll^Fmw, Gll^Fmw, Gll^Fmw, Gs, Gll^Fmw, Gll^Fmw, Gll^Fmw, Gg, Gg, Gg, Gg, Gs, Gg, Gll^Fmw, Gll^Fmw, Gg, Gg, Gs, Gg, Gg, Gg, Gg, Gg, Hh, Gg, Gs, Gg, Gg, Gg, Gg, Gg, Gg, Gs, Gg, Gs, Gg, Gg, Gg, Gg, Gg, Gg, Gg, Gs, Gg, Gs, Gg, Gg, Gg, Gg, Gll^Fmw, Gg, Gg
Gll^Fmw, Gll^Fmw, Gs, Gs, Gll^Fmw, Gll^Fmw, Gll^Fmw, Gg, Gll^Fmw, Gll^Fmw, Gll^Fmw, Gg, Gg, Gll^Fmw, Gll^Fmw, Gg, Gg, Gg, Gg, Gg, Gg, Gg, Gg, Gg, Gg, Gg, Gg, Gg, Gg, Gg, Gg, Gs, Gg, Gs, Gg, Gg, Gg, Gg, Gg, Gg, Gg, Gs, Gg, Gg, Gs, Gg, Gg, Gg, Gg, Gg, Gg, Gg
Gll^Fmw, Gll^Fmw, Gg, Gll^Fmw, Gll^Fmw, Gll^Fmw, Gll^Fmw, Gll^Fmw, Gll^Fmw, Gll^Fmw, Gll^Fmw, Gll^Fmw, Gg, Gg, Gg, Gll^Fmw, Gg, Gg, Gg, Gg, Gg, Gg, Gs, Gg, Gg, Gg, Gg, Gg, Gs, Gg, Gg, Gg, Gg, Gg, Gg, Gg, Gg, Gg, Gg, Gg, Gg, Gg, Gg, Gg, Gg, Gg, Gg, Gg, Gg, Gg, Gg, Gg
Gg, Gg, Gg, Gll^Fmw, Gll^Fmw, Gll^Fmw, Gll^Fmw, Gll^Fmw, Gg, Gll^Fmw, Gg, Gg, Gll^Fmw, Gll^Fmw, Gll^Fmw, Gg, Gg, Gg, Gg, Gg, Gg, Gg, Gg, Gs, Gg, Gg, Gg, Gg, Gg, Gg, Gg, Gg, Gg, Gg, Gg, Gg, Gg, Gg, Gg, Gg, Gg, Gg, Gg, Gs, Gs, Gg, Gg, Gg, Gg, Gg, Gg, Gg
Gs, Gs, Gg, Gg, Gg, Gg, Gg, Gg, Gg, Gg, Gg, Gll^Fmw, Gll^Fmw, Gll^Fmw, Gll^Fmw, Gll^Fmw, Gg, Gg, Gg, Gg, Gg, Gg, Gg, Gs, Gg, Gg, Gg, Gg, Gg, Gg, Gg, Gg, Gs, Gg, Gs, Gs, Gg, Gg, Gg, Gg, Gg, Gg, Gg, Gg, Gs, Gg, Gg, Gg, Gs, Gg, Gg, Gg
Gs, Gs, Gg, Gg, Gg, Gg, Gg, Gg, Gg, Gg, Gg, Gg, Gg, Gll^Fmw, Gg, Gg, Gg, Gg, Gg, Gg, Gg, Gg, Gg, Gg, Gg, Gg, Gg, Gg, Gg, Gg, Gs, Gs, Gg, Gg, Gg, Gg, Gg, Gg, Gg, Gg, Gg, Gg, Gg, Gg, Gg, Gg, Gg, Gg, Gs, Gg, Gg, Gg
Gg, Gs, Gg, Gg, Gg, Gg, Gs, Gg, Gg, Gg, Gg, Gg, Gg, Gg, Gg, Gg, Gg, Gg, Gg, Gg, Gg, Gg, Gg, Gg, Gg, Gg, Gg, Gg, Gg, Gg, Gs, Gg, Gg, Gg, Gg, Gg, Gg, Gg, Gs, Gs, Gs, Gg, Gg, Gg, Gg, Gs, Gs, Gg, Gg, Gg, Gg, Gg
Gs, Gg, Gg, Gg, Gg, Gg, Gs, Gg, Gg, Gg, Gg, Gg, Gg, Gg, Gg, Gs, Gs, Gg, Gg, Gg, Gg, Gg, Gg, Gg, Gs, Gg, Gg, Gg, Gg, Gg, Gg, Gg, Gg, Gg, Gg, Gg, Gg, Gs, Gg, Gg, Gg, Gg, Gg, Gg, Gg, Gg, Gs, Gs, Gg, Gg, Gs, Gs
Gg, Gg, Gg, Gg, Gg, Gs, Gg, Gg, Gg, Gg, Gg, Gg, Gg, Gg, Gg, Gs, Gs, Gg, Gg, Gg, Gg, Gg, Gg, Gg, Gs, Gg, Gg, Gg, Gg, Gg, Gg, Gg, Gg, Gg, Gg, Gg, Gg, Gg, Gg, Gg, Gg, Gg, Gg, Gg, Gg, Gg, Gg, Gg, Gg, Gg, Gg, Gs
